Toplam listede: 257
Zaten vardı: 25
Yeni: 232
Oluşturulan klasör: 232
Oluşturulan placeholder jpg: 928

=== YENİ EKLENENLER (name -> id | categories) ===
- Keyf-i Dem Restaurant Meyhane Kaş -> keyf-i-dem-restaurant-meyhane-kas | ['bar']
- Fıchı Restaurant -> fichi-restaurant | ['food']
- Meydan Restaurant & Cafe - Bistro -> meydan-restaurant-and-cafe-bistro | ['cafe']
- Luna Restaurant & Bar -> luna-restaurant-and-bar | ['bar']
- Yelken Restaurant & Meyhane -> yelken-restaurant-and-meyhane | ['bar']
- Manos Greek Tavern Kas -> manos-greek-tavern-kas | ['food']
- Sidera Restaurant -> sidera-restaurant | ['food']
- Tasra -> tasra | ['food']
- Kas Diva Residence Hotel Restaurant -> kas-diva-residence-hotel-restaurant | ['food']
- Kaya Koruğu -> kaya-korugu | ['food']
- Sushi Kashi -> sushi-kashi | ['food']
- Menta Coffee.co -> menta-coffee-co | ['cafe']
- VOLK by Hera Hotel -> volk-by-hera-hotel | ['food']
- Gaia Kaş -> gaia-kas | ['food']
- Müpptela Ocakbaşi Meyhane -> mupptela-ocakbasi-meyhane | ['bar']
- Cafe Corner Restaurant -> cafe-corner-restaurant | ['cafe']
- Ally's Restaurant -> allys-restaurant | ['food']
- Kaşık Mantı & Ev Yemekleri -> kasik-manti-and-ev-yemekleri | ['food']
- Cinarlar Garden Restaurant Grill & Seafood -> cinarlar-garden-restaurant-grill-and-seafood | ['food']
- Bunbun -> bunbun | ['food']
- Biugra Restoran & Meyhane -> biugra-restoran-and-meyhane | ['bar']
- Pizza Porto -> pizza-porto | ['food']
- Giant Stride Shop & Cafe & Bar -> giant-stride-shop-and-cafe-and-bar | ['bar', 'cafe']
- Vera Veranda Rooftop Restaurant -> vera-veranda-rooftop-restaurant | ['food']
- Nazende Restaurant -> nazende-restaurant | ['food']
- Salkım Ocakbaşı Meyhane Kaş -> salkim-ocakbasi-meyhane-kas | ['bar']
- Maya Steakhouse -> maya-steakhouse | ['food']
- Ruhibey Meyhanesi -> ruhibey-meyhanesi | ['bar']
- Maşuk Meyhane Kaş -> masuk-meyhane-kas | ['bar']
- Bella Vita -> bella-vita | ['food']
- Ehl-i Keyf Meyhanesi Kaş -> ehl-i-keyf-meyhanesi-kas | ['bar']
- Kaş Kuruköprü Çorbacısı -> kas-kurukopru-corbacisi | ['food']
- Doğal Anne Eli -> dogal-anne-eli | ['food']
- Kaş Gurme Falafel -> kas-gurme-falafel | ['food']
- Mumi Cafe & Beach -> mumi-cafe-and-beach | ['cafe', 'beach']
- Kervan Pide ve Kebap Salonu -> kervan-pide-ve-kebap-salonu | ['food']
- The Kitchen by Korsan -> the-kitchen-by-korsan | ['food']
- Bi Lokma Restaurant -> bi-lokma-restaurant | ['food']
- Pirzula Meyhane -> pirzula-meyhane | ['bar']
- Pell’s Gece / Gündüz / Lezzet -> pells-gece-gunduz-lezzet | ['food']
- L’apero -> lapero | ['food']
- Ata Cafe & Bar -> ata-cafe-and-bar | ['bar', 'cafe']
- Bahçe Restaurant -> bahce-restaurant | ['food']
- Passarella Restaurant -> passarella-restaurant | ['food']
- Leymona Beach & Restaurant & Bar -> leymona-beach-and-restaurant-and-bar | ['bar', 'beach']
- Helios Meyhane -> helios-meyhane | ['bar']
- Bekos Kitchen -> bekos-kitchen | ['food']
- Butka -> butka | ['food']
- Adana Kebap Restaurant -> adana-kebap-restaurant | ['food']
- SpaghettiCi -> spaghettici | ['food']
- Ege Restaurant Taner Usta -> ege-restaurant-taner-usta | ['food']
- Marina Restaurant -> marina-restaurant | ['food']
- Aperatif -> aperatif | ['food']
- Taş Bahçe -> tas-bahce | ['food']
- Koi Sushi Bar & Cocktail -> koi-sushi-bar-and-cocktail | ['bar']
- Şişçi Ahmet Kaş -> sisci-ahmet-kas | ['food']
- Noel Baba Cafe & Bistro -> noel-baba-cafe-and-bistro | ['cafe']
- Manzara Restaurant -> manzara-restaurant | ['food']
- Demeti Kaş -> demeti-kas | ['food']
- Tzatziki Meyhane -> tzatziki-meyhane | ['bar']
- Atom Cafe Büfe -> atom-cafe-bufe | ['cafe']
- Kaşım Restaurant -> kasim-restaurant | ['food']
- Üzüm Kızı Meyhane -> uzum-kizi-meyhane | ['bar']
- Dolphin Restaurant -> dolphin-restaurant | ['food']
- Derya Beach Restaurant -> derya-beach-restaurant | ['beach']
- Öz Nazilli Restaurant -> oz-nazilli-restaurant | ['food']
- Kaş Gülşen -> kas-gulsen | ['food']
- Naturel Restaurant -> naturel-restaurant | ['food']
- Hayta Meyhane Restaurant -> hayta-meyhane-restaurant | ['bar']
- Diva’s Restaurant & Bar -> divas-restaurant-and-bar | ['bar']
- Kaş Asma6 Beach Restaurant & Garden Cafe -> kas-asma6-beach-restaurant-and-garden-cafe | ['cafe', 'beach']
- Kaptan Pide Pizza Salonu -> kaptan-pide-pizza-salonu | ['food']
- Yeşil Restaurant -> yesil-restaurant | ['food']
- Bijout Boutique Cafe -> bijout-boutique-cafe | ['cafe']
- Fika Garden Kaş -> fika-garden-kas | ['food']
- Yalı Restaurant -> yali-restaurant | ['food']
- Vira Liman Cafe & Beach -> vira-liman-cafe-and-beach | ['cafe', 'beach']
- Arabın Yeri Kaş -> arabin-yeri-kas | ['food']
- Belmuar Restaurant -> belmuar-restaurant | ['food']
- Kaş Belediyesi Aile Çay Bahçesi -> kas-belediyesi-aile-cay-bahcesi | ['food']
- Kalimera -> kalimera | ['food']
- Maaide Restaurant -> maaide-restaurant | ['food']
- Boom Kitchen Kaş -> boom-kitchen-kas | ['food']
- Pisekar Vegan Food -> pisekar-vegan-food | ['food']
- Meyhane Myra -> meyhane-myra | ['bar']
- Coşdum Pide ve Kebap Salonu -> cosdum-pide-ve-kebap-salonu | ['food']
- Lukka Dining -> lukka-dining | ['food']
- La Moda Beach Hotel -> la-moda-beach-hotel | ['beach']
- Refresh Vegan Kitchen -> refresh-vegan-kitchen | ['food']
- Tellina Restaurant -> tellina-restaurant | ['food']
- Nereid Gurme -> nereid-gurme | ['food']
- Yakamoz Beach Restaurant -> yakamoz-beach-restaurant | ['beach']
- Rolling Rolls -> rolling-rolls | ['food']
- 2000 Restaurant -> 2000-restaurant | ['food']
- Burgermeister Kaş -> burgermeister-kas | ['food']
- Hills Cafe & Bistro -> hills-cafe-and-bistro | ['cafe']
- Kaş Gurme Ev Yemekleri -> kas-gurme-ev-yemekleri | ['food']
- Pi’casa Pizza -> picasa-pizza | ['food']
- Red Box Meze & Cafe -> red-box-meze-and-cafe | ['cafe']
- No 37 Teras -> no-37-teras | ['food']
- Likya Gözleme Evi -> likya-gozleme-evi | ['food']
- Asar Restaurant Kaş -> asar-restaurant-kas | ['food']
- Dürüm Evi Mehmet Usta -> durum-evi-mehmet-usta | ['food']
- Sul-Kaş Restaurant -> sul-kas-restaurant | ['food']
- Kalkan Pasta House -> kalkan-pasta-house | ['food']
- Asmalı Bahçe -> asmali-bahce | ['food']
- Barbarossa Restaurant -> barbarossa-restaurant | ['food']
- Ustalar Pide & Kebap -> ustalar-pide-and-kebap | ['food']
- Akropol -> akropol | ['food']
- Dost Cafe -> dost-cafe | ['cafe']
- Oburus Notos Gastropub -> oburus-notos-gastropub | ['bar']
- Kuşhane Tencere Yemekleri -> kushane-tencere-yemekleri | ['food']
- Food Mest -> food-mest | ['food']
- Dondurma Dükkanı -> dondurma-dukkani | ['food']
- Deniz Restaurant -> deniz-restaurant | ['food']
- Pişi Kahvaltı Kaş -> pisi-kahvalti-kas | ['food']
- Myra Çikolata Evim Kaş -> myra-cikolata-evim-kas | ['food']
- The Kaş Lounge -> the-kas-lounge | ['food']
- Papyon Fast Food -> papyon-fast-food | ['food']
- Noel Baba Cafe Pastanesi -> noel-baba-cafe-pastanesi | ['cafe']
- Za Likya Fast Food -> za-likya-fast-food | ['food']
- Quanta Rock -> quanta-rock | ['food']
- Midyeci Aziz -> midyeci-aziz | ['food']
- AYA Mutfak -> aya-mutfak | ['food']
- Trinity Wine House -> trinity-wine-house | ['food']
- Ali’s 35 Kumru -> alis-35-kumru | ['food']
- Oh Be Kahvaltı & Mutfak -> oh-be-kahvalti-and-mutfak | ['food']
- Mermaid Beach Restaurant -> mermaid-beach-restaurant | ['beach']
- Napitaly -> napitaly | ['food']
- Bozoğlu Et Balık Restaurant -> bozoglu-et-balik-restaurant | ['food']
- Feride Et Lokantası -> feride-et-lokantasi | ['food']
- Kaş Komagene -> kas-komagene | ['food']
- Hatay Ocakbaşı -> hatay-ocakbasi | ['bar']
- Ziizi Pizza Shop -> ziizi-pizza-shop | ['food']
- Küçük Ev Restaurant -> kucuk-ev-restaurant | ['food']
- Güney Antakya Sofrası -> guney-antakya-sofrasi | ['food']
- Talaylar Restaurant -> talaylar-restaurant | ['food']
- Manu Cocktail Bar -> manu-cocktail-bar | ['bar']
- Kor Şiş & Piyaz Restaurant -> kor-sis-and-piyaz-restaurant | ['food']
- Panu -> panu | ['food']
- Misti Drinks & Cocktails -> misti-drinks-and-cocktails | ['bar']
- Tropic Garden Aile Çay Bahçesi -> tropic-garden-aile-cay-bahcesi | ['food']
- Elit Restaurant -> elit-restaurant | ['food']
- Kuşlu Meyhane -> kuslu-meyhane | ['bar']
- Firnaz Restaurant -> firnaz-restaurant | ['food']
- Medusa Hotel & Restaurant -> medusa-hotel-and-restaurant | ['food']
- Öz Hatay -> oz-hatay | ['food']
- Sunrise Breakfast Kaş -> sunrise-breakfast-kas | ['food']
- Gazkesmez Margaz Cuisine & Camping -> gazkesmez-margaz-cuisine-and-camping | ['food']
- Çardak Cafe & Restaurant -> cardak-cafe-and-restaurant | ['cafe']
- Hikaye Fine Dining Cuisine -> hikaye-fine-dining-cuisine | ['food']
- Kled Burger & Sandwich -> kled-burger-and-sandwich | ['food']
- Nox Pub -> nox-pub | ['bar']
- Chacha’mma -> chachamma | ['food']
- Ata Cafe Kumpir & Sarpedons Burger -> ata-cafe-kumpir-and-sarpedons-burger | ['cafe']
- Kaş Bistro -> kas-bistro | ['food']
- Mumi Beach Club -> mumi-beach-club | ['beach']
- Hey’z -> heyz | ['food']
- Tostçu Mesut -> tostcu-mesut | ['food']
- Bi Duble Meze -> bi-duble-meze | ['food']
- Palmiye Cafe -> palmiye-cafe | ['cafe']
- Lycian Corner Bistro -> lycian-corner-bistro | ['food']
- Muazzo Pizza Cafe -> muazzo-pizza-cafe | ['cafe']
- Kırıntı Cafe -> kirinti-cafe | ['cafe']
- Atılgan Cafe -> atilgan-cafe | ['cafe']
- Pebble Beach Bar -> pebble-beach-bar | ['bar', 'beach']
- Gubba -> gubba | ['food']
- Gianni’s Coffee House -> giannis-coffee-house | ['cafe']
- Tedavi Beer House -> tedavi-beer-house | ['bar']
- Kaş Park Restaurant -> kas-park-restaurant | ['food']
- Toby’s Restaurant -> tobys-restaurant | ['food']
- Cèdre -> cedre | ['food']
- Alarga Dine Kaş -> alarga-dine-kas | ['food']
- Mamma Mia Cafe Kaş -> mamma-mia-cafe-kas | ['cafe']
- Muhtarın Yeri -> muhtarin-yeri | ['food']
- Ai Sushi & Asian Cuisine -> ai-sushi-and-asian-cuisine | ['food']
- HOP -> hop | ['food']
- Modo Likya Beach Club & Restaurant -> modo-likya-beach-club-and-restaurant | ['beach']
- Olea Nova Restaurant -> olea-nova-restaurant | ['food']
- Sangria Kaş -> sangria-kas | ['food']
- Romeo’s Pizza Kalkan -> romeos-pizza-kalkan | ['food']
- Defne Restaurant -> defne-restaurant | ['food']
- Kokoreççi Mehmet Usta -> kokorecci-mehmet-usta | ['food']
- Sandro Pizza Burger -> sandro-pizza-burger | ['food']
- Alley Sunset Restaurant -> alley-sunset-restaurant | ['food']
- Can Mocamp & Livorno Pizza -> can-mocamp-and-livorno-pizza | ['food']
- Kaş Belediyesi Sosyal Tesisler -> kas-belediyesi-sosyal-tesisler | ['food']
- Calimera -> calimera | ['food']
- Asmalı Bahçe Kaş -> asmali-bahce-kas | ['food']
- Maya Steakhouse & Wineshop -> maya-steakhouse-and-wineshop | ['food']
- Paninaro Kaş -> paninaro-kas | ['food']
- Deniz Kızı Restaurant -> deniz-kizi-restaurant | ['food']
- Demirci Turizm -> demirci-turizm | ['food']
- Marquis Asian Restaurant -> marquis-asian-restaurant | ['food']
- Chin Dian Restaurant -> chin-dian-restaurant | ['food']
- Olivegardenkas -> olivegardenkas | ['food']
- Mc Sandwhich -> mc-sandwhich | ['food']
- Dominos Pizza -> dominos-pizza | ['food']
- Agora Restaurant & Pool Bar -> agora-restaurant-and-pool-bar | ['bar']
- Meri Garden -> meri-garden | ['food']
- Mola Caffe Oliver Garden -> mola-caffe-oliver-garden | ['food']
- Public Food & Drink -> public-food-and-drink | ['bar']
- Pilav Check Kaş -> pilav-check-kas | ['food']
- Cafe Granda -> cafe-granda | ['cafe']
- Sardelaki -> sardelaki | ['food']
- Tuluhan Gökalp -> tuluhan-gokalp | ['food']
- Karadeniz Pide Salonu -> karadeniz-pide-salonu | ['food']
- Yelken Tatlı & Künefe & Dondurma -> yelken-tatli-and-kunefe-and-dondurma | ['food']
- Bu’burger -> buburger | ['food']
- Meşhur Adıyaman Çiğ Köfteci -> meshur-adiyaman-cig-kofteci | ['food']
- Balık Adam Kokoreç Tavuk Balıkçılık -> balik-adam-kokorec-tavuk-balikcilik | ['food']
- Kippis -> kippis | ['food']
- Deja Vu -> deja-vu | ['food']
- Queen Bar -> queen-bar | ['bar']
- Biralama -> biralama | ['food']
- Deco Stop Bar -> deco-stop-bar | ['bar']
- Maaide Kahvaltı Restaurant -> maaide-kahvalti-restaurant | ['food']
- Wapiano Restaurant -> wapiano-restaurant | ['food']
- Del Mare Kaş Bistro Cafe -> del-mare-kas-bistro-cafe | ['cafe']
- Müptela Kahvaltı -> muptela-kahvalti | ['food']
- Turunç Fırın & Cafe -> turunc-firin-and-cafe | ['cafe']
- Eski Kent Bilardo -> eski-kent-bilardo | ['food']
- Mustafa -> mustafa | ['food']
- Our Home Restaurant & Cafe -> our-home-restaurant-and-cafe | ['cafe']
- Hideaway Bar -> hideaway-bar | ['bar']
- Woon Terrace -> woon-terrace | ['food']
- Friends Pub Kalkan -> friends-pub-kalkan | ['bar']
- The One -> the-one | ['food']
- Ehlikeyf Butik Kahve -> ehlikeyf-butik-kahve | ['cafe']
- Zaika -> zaika | ['food']
- Ehl-i Keyf Kaş Restaurant -> ehl-i-keyf-kas-restaurant | ['food']
- Hikaye Fine Dining Cousine -> hikaye-fine-dining-cousine | ['food']

=== ZATEN OLANLAR (name -> id) ===
- Beyhude Meyhane -> beyhude-meyhane
- Dudu Mutfak -> dudu-mutfak
- Hold&Bite -> hold-and-bite
- Hüseyin'in Yeri Cafe White -> huseyinin-yeri-cafe-white
- Sempati Turkish Cuisine -> sempati-turkish-cuisine
- Bay Kofte -> bay-kofte
- Frida Pub -> frida-pub
- Panorama Restaurant -> panorama-restaurant
- Ora Kebap Restaurant -> ora-kebap-restaurant
- Lily's Corner -> lilys-corner
- Smiley's Restaurant -> smileys-restaurant
- Zuhtu Meze Cocktails -> zuhtu-meze-cocktails
- Oburus Momus -> oburus-momus
- Voyn Meyhane -> voyn-meyhane
- Bilal'in Yeri -> bilalin-yeri
- Zaika Ocakbaşı -> zaika-ocakbasi
- Emre Restaurant -> emre-restaurant
- Zoka Street Food -> zoka-street-food
- Çi Neo Cucina by Mezetaryen -> ci-neo-cucina-by-mezetaryen
- Dragoman Bahçe -> dragoman-bahce
- Memedin Yeri -> memedin-yeri
- The Shotlar Terminali -> the-shotlar-terminali
- Red Point Bar -> red-point-bar
- Ara Bar -> ara-bar
- Oxygen Pub -> oxygen-pub